+--------------------------------------+
|                                      |
|                                      |
|                                      |
|            +----------+       +      |
|            |                  |      |
|   +        |                  |      |
|   |        |                  +--+   |
|   |        +                         |
|   |              |                   |
|   |              |                   |
|   +              |                   |
|                  |                   |
|                        +             |
|                        |             |
|                        |             |
|                        |         +   |
|   +--+       +---------+         |   |
|      |                           |   |
|      |                           +   |
|      +                               |
|                                      |
|                                      |
|                                      |
+--------------------------------------+
