+--------------------------------------+
|                                      |
|                              |       |
|                              |       |
|         +                    |       |
|         |                            |
|         +----------+                 |
|                                      |
|                                      |
|                                      |
|                   +--------------+   |
|                                  |   |
|        |                         |   |
|        |                         +   |
|        |                             |
|        |                             |
|        +--------                     |
|                                      |
|                                      |
|                                      |
|                                      |
|    -------                           |
|                                      |
|                                      |
+--------------------------------------+
