+                                      +
|                                      |
|                                      |
|                                      |
|     +--    -----+                    |
|     |           |                    |
|                                      |
|                        +---   --+    |
|                 |      |        |    |
|     |           |      |        |    |
|     +--    -----+      |        |    |



|       +    +           +---   --+    |
|       |    |                         |
|       |    |                         |
|   +----    --------+                 |
|                                      |
|                                      |
|   +----    -------+                  |
|       |    |                         |
|       +    |                         |
|            +                         |
+                                      +
