+--------------------------------------+
|                                      |
|                              +       |
|                              |       |
|                              +       |
|         +                            |
|         +------------+               |
|                                      |
|                                      |
|                                      |
|                        +             |
|                        |             |
|               +        |             |
|               |        +---------+   |
|               |                      |
|               |                      |
|               |                      |
|               +----------------+     |
|                                      |
|    |                                 |
|    |                                 |
|    |                                 |
|                                      |
|                                      |
+--------------------------------------+